111111
100001
102301
100001
100001
111111